7 7
3 3
*******
*** ***
*** ***
*E    *
*** ***
*** ***
*******