10 20
1 4
********************
*     WWWWWW*      *
* ** LLLL *W* * ****
*  * LLLL * * *    *
* ** LLLL *   ** ***
* *         * ** ***
* * **** **L* *    *
* *   LL    * * ** *
* *LLLLLLLL * * *E *
********************
10 10
2 4
**********
*    WWW *
* ** *** *
*WWLLLL  *
**W**LL **
* WWWLL **
**** *   *
*      ***
* *E* ****
**********
10 10
2 4
**********
*        *
* ** *** *
*  LLLL  *
** **LL **
*    LL **
**** *WWW*
* WWWWW***
* *E* ****
**********
10 10
1 2
**********
*        *
* **L*** *
*   LLLL *
** *LLL **
*WWWW*  **
**** *   *
*      *L*
* *E* *LL*
**********
20 20
1 18
********************
*     *     *      *
* ********* * ******
*         * * *    *
* *********   ******
* *  LLLLLLL*  W*LL*
* * ********* *W   *
* *         * *W** *
* ********* * *W** *
* WWWWWWWWW        *
* LLLLLLL LLLLLLL **
* LLLLLLL LLLLLLL **
*    *        *    *
* ******* ***** ** *
*    *LLLLL*     * *
*** ********* ******
*     *E    *      *
* ********* * ******
*                  *
********************

