10 20
1 4
********************
*     WWWWWW*      *
* ** LLLL *W* * ****
*  * LLLL * * *    *
* ** LLLL *   ** ***
* *         * ** ***
* * **** **L* *    *
* *   LL    * * ** *
* *LLLLLLLL * * *E *
********************

