7 7
3 3
*******
*** ***
*** ***
*     *
*** ***
*** ***
*******